11111111111111111111111111111
10000000000000000000000000001
10000000001100000111100000001
1P0E0000010100000000010000001
10000000100100000000010000001
10000001000100000000100000001
10000011111110000001000000001
100000000N0100000010000000001
10000000000100000111111000001
10000000000N00000000000000001
10000000000N000C0000000000001
10000000000N00000000000000001
11111111111111111111111111111