11111111111111111111111111111
10000000000C00000000000000001
10000000001100000111100000001
100E0000010100000000010000001
10000000100100000000010000001
100000010001000C0000100000001
10000011111110000001000000001
100000000NC100000010000000001
10000000000100000111111000001
100P0000000000000000000000001
10000000000N00000000000000001
10000000000N00000000000000001
11111111111111111111111111111