1111111111
1P00000C01
1001111101
10000E0101
1010011101
1111111111